...............T
................
................
...OOOOOOOOOOOOO
................
................
................
OOOOOOOOOOOOO...
................
................
S...............
