..............T
...............
...............
...OOOOOOOOOOOO
...............
...............
...............
OOOOOOOOOOOO...
...............
...............
S..............
