.....O....T
.....O.....
...........
.....O.....
.....O.....
O.OOOO.....
.....OOO.OO
.....O.....
.....O.....
...........
S....O.....
