..............T
...............
...............
..XOOOOOOOOOOOO
...............
.......X.......
...............
OOOOOOOOOOOOX..
...............
...............
S..............
